5
8
2
########
#_$.___#
#_@____#
#__$__.#
########
